5
5
0,0,0,0,0
0,1,0,0,0
1,1,0,0,S
0,1,1,1,1
E,1,0,0,0